#######
#A    #
# ### #
#   # #
### # #
#   # #
# #   #
#   #B#
#######
